{
  "name": "Level 1",
  "rows": 5,
  "cols": 10,
  "brickMap": [
    [1,1,1,1,1,1,1,1,1,1],
    [1,2,2,2,2,2,2,2,2,1],
    [1,2,3,3,3,3,3,3,2,1],
    [1,2,2,2,2,2,2,2,2,1],
    [1,1,1,1,1,1,1,1,1,1]
  ],
  "previewImagePath": "level1_preview.png"
}
