{
  "name": "Level 8: Bedrock Maze",
  "rows": 8,
  "cols": 12,
  "brickMap": [
    [1,1,1,1,1,1,1,1,1,1,1,1],
    [1,0,1,0,1,0,1,0,1,0,1,1],
    [1,1,1,0,1,1,1,0,1,1,1,1],
    [1,0,1,0,0,0,1,0,0,0,1,1],
    [1,0,1,0,1,1,1,0,1,0,1,1],
    [1,0,1,0,1,0,1,0,1,0,1,1],
    [1,1,1,1,1,0,1,1,1,1,1,1],
    [2,2,2,2,2,0,3,3,3,3,3,3]
  ],
  "previewImagePath": "level8_preview.png"
}
