{
  "name": "Level 10: Final Wall",
  "rows": 7,
  "cols": 12,
  "brickMap": [
    [0,0,0,0,0,0,0,0,0,0,0,0],
    [3,3,3,3,3,3,3,3,3,3,3,3],
    [0,3,3,3,3,3,3,3,3,3,3,0],
    [0,0,2,2,2,2,2,2,2,2,0,0],
    [0,0,2,2,2,2,2,2,2,2,0,0],
    [0,0,0,1,1,1,1,1,1,0,0,0],
    [0,0,0,1,1,1,1,1,1,0,0,0]

  ],
  "previewImagePath": "level10_preview.png",
  "backgroundPath": "scene1.png",
  "index": 10
}
