{
  "name": "Level 1",
  "rows": 5,
  "cols": 10,
  "brickMap": [
    [1,1,1,1,1,1,1,1,1,1],
    [1,0,0,0,0,0,0,0,0,1],
    [1,0,1,1,1,1,1,1,0,1],
    [1,0,0,0,0,0,0,0,0,1],
    [1,1,1,1,1,1,1,1,1,1]
  ],
  "previewImagePath": "level1_preview.png"
}
