{
  "name": "Level 3",
  "rows": 20,
  "cols": 18,
  "brickMap": [
    [0,0,0,0,0,0,0,0,0,0,0,0,0,0,0,0,0,0],
    [0,1,1,1,1,1,1,1,1,1,1,1,1,1,1,1,1,0],
    [0,1,1,1,1,1,1,1,1,1,1,1,1,1,1,1,1,0],
    [0,1,1,1,1,1,1,1,1,1,1,1,1,1,1,1,1,0],
    [0,1,1,1,1,1,1,1,1,1,1,1,1,1,1,1,1,0],

    [0,1,1,1,1,1,1,1,-1,-1,1,1,1,1,1,1,1,0],
    [0,1,1,1,1,1,1,1,-1,-1,1,1,1,1,1,1,1,0],
    [0,1,1,1,1,1,1,1,-1,-1,1,1,1,1,1,1,1,0],
    [0,1,1,1,1,1,1,1,-1,-1,1,1,1,1,1,1,1,0],
    [0,1,1,1,1,1,1,1,-1,-1,1,1,1,1,1,1,1,0],

    [0,1,1,1,1,1,1,1,-1,-1,1,1,1,1,1,1,1,0],
    [0,1,1,1,1,1,1,1,-1,-1,1,1,1,1,1,1,1,0],
    [0,1,1,1,1,1,1,1,-1,-1,1,1,1,1,1,1,1,0],
    [0,1,1,1,1,1,1,1,-1,-1,1,1,1,1,1,1,1,0],
    [0,1,1,1,1,1,1,1,-1,-1,1,1,1,1,1,1,1,0],

    [0,1,1,1,1,1,1,1,-1,-1,1,1,1,1,1,1,1,0],
    [0,1,1,2,1,1,1,1,-1,-1,1,1,1,2,1,1,1,0],

    [0,1,1,1,1,1,1,1,1,1,1,1,1,1,1,1,1,0],
    [0,1,1,1,1,1,1,1,1,1,1,1,1,1,1,1,1,0],
    [0,0,0,0,0,0,0,0,0,0,0,0,0,0,0,0,0,0]
  ],
  "previewImagePath": "level3_preview.png"
}
