{
  "name": "Level 6: Rain Drops",
  "rows": 5,
  "cols": 12,
  "brickMap": [
    [1,0,1,0,1,0,1,0,1,0,1,0],
    [1,0,1,0,1,0,1,0,1,0,1,0],
    [0,1,0,1,0,1,0,1,0,1,0,1],
    [0,1,0,1,0,1,0,1,0,1,0,1],
    [2,0,2,0,2,0,2,0,2,0,2,0]
  ],
  "previewImagePath": "level6_preview.png"
}
