{
  "name": "Level 1",
  "rows": 10,
  "cols": 15,
  "brickMap": [
    [1,1,1,1,1,1,1,1,1,1,1,1,1,1,1],
    [1,0,0,0,0,0,0,0,0,0,0,0,0,0,1],
    [1,0,1,1,1,1,1,1,1,1,1,1,1,0,1],
    [1,0,0,0,0,0,0,0,0,0,0,0,0,0,1],
    [1,1,1,1,1,1,1,1,1,1,1,1,1,1,1],
    [1,0,0,1,0,0,1,0,0,1,0,0,1,0,1],
    [1,0,1,0,1,0,1,0,1,0,1,0,1,0,1],
    [1,0,0,0,0,0,0,0,0,0,0,0,0,0,1],
    [1,1,1,1,1,1,1,1,1,1,1,1,1,1,1],
    [1,0,0,0,1,1,0,0,1,1,0,0,1,1,1]
  ]
}
