{
  "name": "Level 3",
  "rows": 6,
  "cols": 10,
  "brickMap": [
    [1,0,1,0,1,0,1,0,1,0],
    [0,1,0,1,0,1,0,1,0,1],
    [1,0,1,0,1,0,1,0,1,0],
    [0,1,0,1,0,1,0,1,0,1],
    [1,0,1,0,1,0,1,0,1,0],
    [0,1,0,1,0,1,0,1,0,1]
  ],
  "previewImagePath": "level3_preview.png"
}
