{
  "name": "The Wall",
  "rows": 7,
  "cols": 12,
  "brickMap": [
    [0,0,1,1,1,1,1,1,1,1,0,0],
    [0,1,1,0,0,0,0,0,0,1,1,0],
    [1,1,0,1,0,0,0,0,1,0,1,1],
    [1,0,1,1,0,0,0,0,1,1,0,1],
    [1,1,0,1,0,0,0,0,1,0,1,1],
    [0,1,1,0,0,0,0,0,0,1,1,0],
    [0,0,1,1,1,1,1,1,1,1,0,0]
  ]
}
