{
  "name": "Level 7: The U",
  "rows": 8,
  "cols": 12,
  "brickMap": [
    [3,3,0,0,0,0,0,0,0,0,3,3],
    [3,3,0,0,0,0,0,0,0,0,3,3],
    [3,3,0,0,0,0,0,0,0,0,3,3],
    [3,3,0,0,0,0,0,0,0,0,3,3],
    [3,3,0,0,0,0,0,0,0,0,3,3],
    [3,3,1,1,1,1,1,1,1,1,3,3],
    [3,3,1,1,1,1,1,1,1,1,3,3],
    [3,3,1,1,1,1,1,1,1,1,3,3]
  ],
  "previewImagePath": "level7_preview.png"
}
