{
  "name": "Level 9: Diamond Mine",
  "rows": 9,
  "cols": 12,
  "brickMap": [
    [1,1,1,1,1,1,1,1,1,1,1,1],
    [1,1,1,1,2,1,1,2,1,1,1,1],
    [1,1,1,2,1,2,1,2,1,2,1,1],
    [1,1,2,1,2,1,2,1,2,1,2,1],
    [1,2,1,2,1,3,3,1,2,1,2,1],
    [1,1,2,1,2,1,2,1,2,1,2,1],
    [1,1,1,2,1,2,1,2,1,2,1,1],
    [1,1,1,1,2,1,1,2,1,1,1,1],
    [1,1,1,1,1,1,1,1,1,1,1,1]
  ],
  "previewImagePath": "level9_preview.png"
}
